• Địa Lý
Ah → 安国 → An hay An Quốc
Aquah → 水安 → Thủy An
Chaosah → 州沙 → Châu Sa
Hippiah → Hy Phanh
Hereva → 河日下 → Hà Nhật Hạ
Lake Of Horns → Hồ Sừng
Magmah →  马客安 → Mã Khách An
Komona → 空木成 → Thành Phố Không Mộc hay Không Mộc Thành
Qualicity → Qủa Lý Thành
Squirrel's End  → Sóc Cùng
Tenebrume → Tối Mù
Zombiah → Qũy Thân An

• Nhân Vật
Arra - A Ra
Carrot → Củ Đỏ
Camomile → Cúc La Mã.
Cayenne → Cây Yến Nhi
Coriander → Cây Rau Mùi
Cu Min → 古明 → Cổ Minh
Dibs - Đi Bi
Lord Azeirf → 德阿责福 → Đức A Trách Phức
Queen Aiel → 女皇爱惜 → Nữ Hoang Aí Thích
Pepper → Hạt Tiêu
Saffron → Xà Phòng
Shichimi → 七味 → Thất Vị
Spirilina → Ốc Lý Na
Thyme → Thị Mỹ
Torreya - Thổ Rễ Nha
Truffle → Nấm Cục
Vinya - Vinh Da
Wasabi (わさび) →　Cải Ngựa


Tuổi thọ
Saffron > Cây Rau Mùi > Hạt Tiêu > Thất Vị

• Báo Chí/tạp chí
Hereva Style Gazette → Tập Chí Phong Cách Hà Nhất Hạ
Qualcity Daily → Nhật Báo Qủa Lý Thành
The Komonan → Không Mộc Báo

• Đơn vị tiền
Ko → Không Mộc Tệ (tắt KMT, đơn vị tiền của Không Mộc Thành)

• Giờ
AirMoon → Sáng (trước 12 giờ trưa)
PinkMoon → Chiều/Tối (sau 12 giờ trưa)

• Ngày
Azarday → Ngày Thứ Nhất
Babkaday → Ngày Thứ Hai
Cetoday → Ngày Thứ Ba
Donday → Ngày Thứ Tư
Eggday → Ngày Thứ Năm
Fookuday → Ngày Thứ Sáu

• Hội Đồng
Council Of Three Moons → Hội Đồng Tam Nguyệt 

• Loại Cây
Water Tree → Thủy Mộc